..........................
..........................
...#####............#####.
...#..##............##..#.
.###....##..%.%...##.....#
.#......##........##.....#
##......##%.%.%.%.##.....#
##......##........##.....#
##.....###%.@@@@%.###...##
##.....###..@@@@..###...##
.#....##~.~.~.~.~.~.######
.#######............######
..######@@@@##@@@@#######.
..######@@@@##@@@@#######.
....####@@..##..@@#####...
....####@@..##..@@#####...
....###################...
....###################...
##%.######@@@@########%.##
##........@@@@..........##
##%.%.%.%.%.%.%.%.%.%.%.##
##......................##
....%.%.%.......%.%.%.%...
...........####...........
......#....#..#.....#.....
......#....#..#.....#.....
