..........@@..##..####....
..........@@..##..####....
...#########..##..........
...#########..##..........
......#...##..####..%.%.%.
......#...##..####........
...#..........@@..%.%.%.%.
...#..........@@..........
...#..######@@####%.%.##@@
...#..######@@####......@@
..######@@....##..%.%....#
........@@....##.........#
.#######..@@%.%.%.%.%.....
.#######..@@..............
......@@....%.%.%.%.%.##..
......@@..............##..
@@##..%.%.%.%.@@%.%.%.##..
@@##..........@@......##..
.###%.%.%.%.%.........###.
.###..................###.
..##%.%.........@@######..
..##..............######..
....%.%...........##...#..
...........####...##...#..
....%.%....#..#...........
..##.......#..#...........
