..............######......
..............######......
..######..........##......
..########..##....##......
........##..##........####
........##............####
..~.~.~.~.~...###.....##@@
..............###.....##..
..........~...##..@@@.##..
....@@@@@@....##..@@@.##..
##..######~.~.~...~.####..
##..######..........####..
........@@~.......~.@@....
........@@................
~.~.~...~.~.####..~.......
............####..........
..........##@@@@..~.~.~...
..........##..............
######....................
######....................
....##..@@@@......####...#
....##............####...#
##................##....##
##.........####...##....##
...........#..#...........
...........#..#...........
