..........................
........##......##........
..########......########..
..########......########..
..##........##........@@..
..##........##........@@..
..##..####......####..####
..##..##..........##..####
..##..#.%...@@..%..#..@@##
..##..#...@@@@@@...#..@@##
..##....%.%.%.%.%.....@@##
........................##
##......%.%.%.%.%.......##
##@@..................####
##@@..#.%.@@@@@@%..#..##..
##@@..#.....@@.....#..##..
####..##..........##..@@..
####..####......####..@@..
##@@........##........##..
##@@........##........##..
##########......######@@@@
##########......######@@@@
####....##......##....##..
####.......####.......##..
####.......#..#...........
####.......#..#...........
