..........................
..........................
%.%.......######......%.%.
........##########........
%......############.....%.
.......############.......
......####%.##%.####......
......####..##..####......
......##%.%.##%.%.##......
......##....##....##......
%.....##############....%.
......##############......
%.%.....##%.##%.##....%.%.
........##..##..##........
~.~.~...##########..~.~.~.
........##########........
.........#.#.#.#.#........
.........#.#.#.#.#........
........#.#.#.#.#.........
........#.#.#.#.#.........
.@.@.@..............@.@.@.
.@.@.@..............@.@.@.
#.#.#................#.#.#
#.#.#......####......#.#.#
@.@.@..@...#..#...@..@.@.@
@.@.@..@...#..#...@..@.@.@
