........####....##........
........####....##........
..%.%.####......##........
......####......##........
%.%.%.%.%.%.%.%.####......
................####......
%.@@##%.######%.%.%.%.##@@
....##..######........##@@
%.%.##%.%.%.@@%.%.##@.##..
....##............##@.##..
..%.%.##..%.%.%.%.##..##..
......##@@........##..##..
..##########%.%.#####.%.%.
..##########....#####.....
.@@@####......####......%.
.@..####......##..........
..##..##......##%.%.###.%.
..##..##....##......###...
..##......@@##%.%.##....%.
..##.....###......##......
..#####..###%.%...%.##%.%.
..#####..###....##..##....
....##...#......##%.##%...
....##..%..####.##........
....##.....#..#...%.%.%...
...........#..#...........
