..........................
..........................
....@@%.@@................
....@@..@@................
......%...%...............
............@@............
..%.........%.............
..............##..........
..%.%.....%...%...........
................@@........
..%...%...%.....%.........
..................##......
..%.....%.......%.%.......
....................@@....
....%.........%.%.%.%.....
......................##..
......%.....%...%.%.%.%...
..........................
##..........%.....%.%.%.@@
##......................@@
####..........%...%.%.%.%.
####......................
@@####..........%...%.%.%.
@@####.....####...........
@@@@####...#..#.%.....%.%.
@@@@####...#..#...........
