..........................
.......##...........##....
..##..###...........####..
..##..###...........####..
..##....##..@@............
..##....##..@@............
......@.##....##..........
......@.##....##..........
............####.##.......
............####.##.......
.....@........##.##...@@@@
.....@........##.##.......
########..............####
########..............####
......####.......@........
......####.......@........
..######........####..##..
..######........####..##..
......##..........##..##..
......##..........##..##..
..........@@..@@......##..
....................####..
##................##......
##.........####...##......
####@......#..#...##..##..
####@......#..#...##..##..
