................@@@@@@%...
................@@@@@@....
..##............@@....@@..
..##............@@....@@..
##%.##......########..@@..
##..##......########..@@..
..##%.##....##..%.##@@@@..
..##..##....##....##@@@@..
....##..%.@@##%...##......
....##....@@##....##......
........@@..##@@####......
........@@..##@@####......
....####@@##..@@..........
....####@@##..@@..........
....##..%.##@@%...........
....##....##@@............
@@@@@@%...##....####......
@@@@@@....##....####......
@@..########....##@@@@....
@@..########....##@@@@....
@@....@@..........@@####..
@@....@@..........@@####..
%.@@@@@@............##@@@@
..@@@@@@...####.....##@@@@
...........#..#.......@@@@
...........#..#.......@@@@
