..##..##..##..##..##..##..
..##..##..##..##..##..##..
..##..##..##..##..##..##..
..##..##..##..##..##..##..
..@@..@@..@@..@@..@@..@@..
..........................
........##......##........
##..##..##......##..##..##
##..######..##..######..##
##..##..##..##..##..##..##
@@..@@..@@..@@..@@..@@..@@
........@@......@@........
%.%.....##..%...##....%.%.
........##......##........
%.%.%.%.####%.####%.%.%.%.
........##......##........
%.%.%.%.%.%.%.%.%.%.%.%.%.
..........................
........##%.%.%.##........
##..##..##......##..##..##
..##..##....%.....##..##..
..##..##..........##..##..
..##..##..........##..##..
..##..##...####...##..##..
..##..##...#..#...##..##..
...........#..#...........
