......@@......@@..........
......@@......@@..........
..##..@@......##..##..##..
..##..@@......##..##..##..
..##..........##..##@@##..
..##........####..##@@##..
......##..........@@......
......##..........@@......
%.....##....@@....##%.##@@
......##....@@....##..##@@
%.%.......##....@@..%.....
..........##....@@........
..######%.%.%.@@....%.##..
..######......@@......##..
......@@%.##..##..##..##..
......@@..##..##..##..##..
@@##..@@..##..##......##..
@@##..@@..##..##......##..
..##..##..######..##..##..
..##..##..######..##..##..
..##..##..######..........
..##..##..................
..##..............##..##..
..##.......####...##..##..
..##..##...#..#...######..
..##..##...#..#...######..
