......~...##....##..##....
..........##....##..##....
................##..@@....
................##..@@....
......~.....@@..##..##....
..........##@@..##..##....
@@..##~...@@....##..##....
....##....@@..##....##....
....##~.......##..........
....##........##..........
##..##~.~...~.~.~.~.....##
##..##..................##
..............%...~...@@@@
......##..................
####.###..@@%.%.%.~.......
####.###..@@..........####
##...#....##%.%.%.~...##..
.....#....##..........##..
..........##..%...~...%...
..@@......##..............
..##......######....%.%.%.
..##..@@..................
..##..##..........~.%.%.%.
..##..##...####...........
...........#..#...~...%...
...........#..#...........
