..........................
......######....##........
....################......
..##################......
..%.%.%.%.%.%.%.%.####....
..................####....
%.%.............%.%.####..
....................####..
%...@@....@@......%.%.%...
....@@....@@..............
%...@@....@@......%.%.%...
....@@....@@..............
%.....%.........%.%.#####.
....................#####.
%.%.%.%.%.%.%.%.%.#######.
..................#######.
##%.%.####%.%.%.########..
##....####......########..
..####################..@@
..####################..@@
@@..##@@#############...@@
@@..##@@#############...@@
..@@####@@......####@@@@@@
..@@##..@@.####.####@@@@@@
...........#..#...........
...........#..#...........
