..........%...............
..........................
........%.@@%.............
..........@@..............
....%.....%.....%.%.......
..........................
..%.##%.......%.####%.....
....##..........####......
....%.##%.......%.%.....%.
......##..................
%.....%.....%.........%.@@
........................@@
##%.......%.@@%.....%...%.
##..........@@............
@@##%.......%.....%.@@%...
@@##................@@....
##%.....%.......%...%.....
##........................
%.....%.##%...%.##%.......
........##......##........
......%.##%.....%.....%...
........##................
..%.....%...........%.@@%.
...........####.......@@..
%.@@%......#..#...%.##%...
..@@.......#..#.....##....
