..........................
..........................
..........@@@@............
..........@@@@............
............@@............
............@@............
..@@@@%.%.##@@##%.%.@@@@..
..@@@@....##@@##....@@@@..
......@@%.%.@@%.%.@@......
......@@....@@....@@......
%.......@@%.%.%.@@......%.
........@@......@@........
@@%.......%.%.%.......%.@@
@@......................@@
%.........@@%.@@........%.
........@@......@@........
........@@......@@........
........@@..@@..@@........
......@@....@@....@@......
......@@....@@....@@......
..........................
..........................
..........................
...........####...........
....@@.....#..#.....@@....
....@@.....#..#.....@@....
