....@@..##@@.........#....
....@@..##...........#....
....##..##%...########....
....##..##......######....
..%.%...##%..##.......@@@@
........##...##.......@@@@
%.%.%.%.%.%.######...###..
............######...###..
....%.%.....@@##...#####.#
........####..##...###...#
##@@....####......####...#
##....##..........##.....#
.#....##..................
.#..####..................
.#..##....................
.#........................
....@@....................
....@@....................
##..##....................
##..##....................
.#..##....................
.#..##....................
.#..##....................
.#..##.....####...........
....##.....#..#...........
...........#..#...........
