....~.~...................
..........................
......~.%...#.............
@@..........#.............
%...........@...#...~.~...
..@@........@...#.........
%.%...@@...#....@.%.~.....
........##.#....@.........
%.%.%.....@@...#..........
..........@@##.#........@@
%.%.@@.....#..@@........%.
......@@...#..@@##....@@..
%.@@....##@@...#..@@..%.%.
..........@@...#..........
..........#.##@@....%.%.%.
..........#...@@..........
....~.%..@....#.##..@@%.%.
.........@....#...@@......
..~.~....#...@..........%.
.........#...@............
.............#..%.~.....@@
.............#............
@@................~.~.....
@@.........####...........
@@@@.......#..#.........@@
@@@@.......#..#.........@@
