........@@................
........@@................
@@@@....@@....@@@@........
@@@@....@@....@@@@........
..@@....@@......@@..@@@@%.
..@@....@@......@@..@@@@..
..@@....@@@@@@..%...@@....
..@@....@@@@@@......@@....
..##........@@..@@@@@@....
..##........@@..@@@@@@....
%.@@@@..@@##@@####........
..@@@@..@@##@@####........
....@@%.@@%.....##....@@@@
....@@..@@......##....@@@@
....@@....%.....@@....@@..
....@@..........@@....@@..
....##....@@....@@@@##@@..
....##....@@....@@@@##@@..
%.@@@@@@%.%.##@@@@..##@@..
..@@@@@@....##@@@@..##@@..
......##........%.%...##..
......##..............##..
......@@..........%...##..
......@@...####.......##..
......@@...#..#...@@..##..
......@@...#..#...@@..##..
