.....................@@...
.....................@@...
....................@@....
............@@......@@....
............%.....###.....
..........##..##..###.....
..........%.%.%...###.....
........@@......@@###.....
........%.%...%.%.###.....
......##..........###.....
......%.%.......%.%.#.....
....@@..............#.....
....%.%...........%.%.....
..##..................##..
..%.%...............%.%...
@@......................@@
%.%...................%.%.
..........................
..%...................%...
..........................
..%...................%...
..........................
..%...................%...
...........####...........
..%........#..#.......%...
...........#..#...........
