....................##....
....................##....
..##~.~...@@..##..........
..##......@@..##..........
....~.~.##%.%.%.~.~...@@..
........##............@@..
..........%.%.%.~.~.##....
....................##....
..@@....~.~...%...........
..@@......................
%.%.##..~.~.@@........##..
....##......@@........##..
%.%.%.............@@....@@
..................@@....@@
..##~.~...##..............
..##......##..............
@@..~.~.%.%.~.~.%.%...##..
@@....................##..
........%...~.~.%.%.~.~...
..........................
......@@%.......%.%.~.~...
......@@..................
....##..##................
....##..##.####...........
##.........#..#...##@@....
##.........#..#...##@@....
