........##......##........
........##......##........
..%.%.%.##................
........##..........@@@@@@
##%.%.%...................
##........................
%.%.%.%.......##..#######.
..............##..#######.
%.%.%.%.########..##...#..
........######....##...#..
%.%.%.%.....##.........#..
............##.........#..
..%.........@@@@@@....%...
............@@@@@@........
..................%.%.%.%.
..##..##..................
###..####..#######%.%.%.%.
###..####..#..............
..........##......%.%.%.%.
..........##..####........
##....@...........%.%.%...
##....@...................
####..@...........%.%.%...
####..@....####...........
@@####.....#..#...##......
@@####.....#..#...##......
