..........................
..........................
..........................
..........####......@@....
..........%.%.......%.....
..@@@@..##....@@..##..##..
..%.%...%.%.%.%...%.%.%...
##....##........##......##
%.%.%.%.%.%.%.%.%.%.%.%.%.
..........................
@@%.~.%.%.%.%.%.~.%.%.%.%.
@@........................
%.%.~.~.~.%.%.%.~.~.~.%.@@
........................@@
%.%.%.%.~.%.@@%.%.%.~.%.%.
............@@............
%.%.%.%.%.%.%.%.%.%.%.%.%.
..........................
%.%.%.%.%.####%.%.%.%.%.@@
..........................
@@%.%.%.##....##%.%.%.@@..
..........................
..@@####........######....
...........####...........
...........#..#...........
...........#..#...........
