......~.........~.........
..........................
~.~...~...~.~.~.~...~.~.~.
..........................
%.%.##....##....~...~.%.~.
....##....##..............
%.~.~.~.~...@@....##%.%.%.
............@@....##......
%.%...~.....~...~.~.~.~.%.
..........................
~.~...~...~.~.....~.......
..........................
....##%.##..##%...~.....~.
....##..##..##............
..~.~.%.~.~.~.~...%.##..~.
....................##....
##....##....~...%.%.~...~.
##....##..................
~.~...~.~...~.##~.~.~.....
..............##..........
....##..%.%.....%.~.....~.
....##....................
..~.~.~.%.........~...~.~.
...........####...........
..~........#..#...........
...........#..#...........
