..........................
..........................
..........................
..........................
......##..........##......
......##..........##......
..##..##..##..##..##..##..
..##..##..##..##..##..##..
..######..........######..
......##..........##......
......##..##@@##..##......
......######@@######......
@@........@@..@@........@@
@@......................@@
..........................
..........##..##..........
..........##..##..........
..........##..##..........
......##..........##......
......##....##....##......
..##..##..@@@@@@..##..##..
..##..##..........##..##..
..##..##..........##..##..
..######...####...######..
..##.......#..#.......##..
...........#..#...........
