........@@........@@......
........@@........@@......
..@@......@@....@@%.%.....
..@@......@@....@@........
....@@........@@%...@.....
....@@........@@..@@@.....
......@@..%.%.%.%.%....@..
......@@...............@..
..@.....@@%.%.@@%.....@@..
..@.....@@....@@......@@..
..@@@.%...@@%.%.@@.....@..
....@.....@@....@@.....@..
....%.%.%.%.%.....@@......
..................@@......
....@.%...@@%.......@@....
..@@@.....@@........@@....
..%.%.%.@@..@@........@@..
........@@..@@..@@....@@..
%.%.%.@@.........@........
......@@.........@........
....@@.................@@@
....@@.................@@@
....................@.....
...........####...@@@.....
@..........#..#...........
@...@@.....#..#...........
