..........................
..........................
........##..##............
........##..##............
%.....%.##%.##%.....%.....
........##..##............
##%.%.##########%.%.##%...
##....##########....##....
########@@##@@########%...
########@@##@@########....
~.~.~.##########~.~.~.%...
......##########..........
~.##################~.~.%.
..##################......
######~.######~.######%.%.
######..######..######....
####~.~.~.##~.~.~.####~.~.
####......##......####....
%.~.~.%.%.%.%.%.~.~.%.~.%.
..........................
..%.%...........%.%...%...
..........................
..........................
...........####...........
...........#..#...........
...........#..#...........
