..%.%.................%...
..........................
%.%.......####..........%.
........##########........
%......#############....@@
.......###############....
@@....#################...
......#################...
.....###......######..#...
.....#..........####..#...
~....#..@...@...###.......
.....#..@...@...###.......
....##..........###...~.~.
....##..####....###.......
....################......
....################......
...##################.....
...##################.....
..####################....
......############........
..####..########..####..%.
..######..####..######....
%...####........####..%.%.
...........####...........
@@%........#..#.....%.%.@@
@@.........#..#.........@@
