........####..............
........####..............
........##......@@@@@@....
@@..##..##..........@@....
@@..##......##............
@@..##......##............
##..######..####..~.~...~.
##..######..####..........
##......##........~.......
..........................
........~.~...~.~.~...####
....##................####
####....~.##..###.........
####......##..###.........
........~............@@...
.....................@@...
~.~.~...~...@@..##...@....
............@@..##...@....
.....................@####
......####...........@####
........##########........
........##......####......
######............####....
####.......####.....##....
##.........#..#...........
...........#..#...........
