...........#..#.%.%.......
...........#..#...........
..#..@..#........#%.#..#%.
..#..@..#........#..#..#..
..#..@..#...##...#%.#..#%.
..#..@..#...##...#..#..#..
..##....##..@@..##%...##%.
..##....##..@@..##....##..
.......#@@..##..##@...%.%.
.......#....##....@.......
#####.....%.##%......#####
#####.......##.......#####
.........#%.%.%.#.........
.........#......#.........
@@####..##%.%.%.##.#####@@
@@####.............#####@@
@@@@@@......%.......@@@@@@
........##......##........
..##....##......##........
..##....##......##........
..###.....##..##.....###%.
..###................###..
....##..............%.%.%.
...........####...........
...........#..#.......%.%.
....##.....#..#.....##....
