..............@@@@........
..........................
....@@@@@@@@........@@....
....@@..............@@....
....@@......%...@@@@@@....
....@@............@@@@....
..@@......%.@@......@@....
..@@........@@......@@....
........%.@@@@......@@@@..
..........@@@@........@@..
..@@..%.@@@@@@..@@........
..@@....@@@@@@..@@........
...@..@@@@......@@@@......
...@..@@@@......@@@@......
@.......@@..@@@@@@.....@..
@.......@@..@@@@@@.....@..
...@@@......@@@@%.....@@..
...@@@......@@@@......@@..
..@@........@@%.....@@@@..
..@@........@@......@@@@..
..@@@@@@....%.....@@......
......@@..........@@......
..................@@....@@
...........####.......@@@@
...........#..#...........
@@@@.......#..#...........
