....##....##......##......
....##....##..##..##......
%.######..##......###.....
..######..##..@@..###.....
%.%.%.....##..##..##...##.
..............##.......##.
%.~.~.~.~.~.~.~.~.~.~...~.
..........................
..##......................
..##........####..........
....##.....###########@@@@
....##.....#####..##......
####..##...#####%.##....##
####..##...#####..##@@@@##
......@@......%.%.%.%.....
......@@..@@..............
~.~...~.~.~.~.~...~.~.~.~.
..........................
%.%....#..................
.......#....####..........
%.%.##..#......#......##..
....##..#......#..@@####..
%...##..#.........##..##..
..@@##..#..####.......##..
...........#..#.......##..
...........#..#...##......
