......##............%.....
......##..........@@......
##............%..@@@@...##
##..........@@...@@@@...##
........%..@@@@...@@%.....
......@@...@@@@...........
.....@@@@...@@%...........
.....@@@@.................
......@@%.................
..........................
......%...%...%...%.......
........@@......@@........
@@##...@@@@....@@@@...##@@
@@##...@@@@....@@@@...##@@
......%.@@%...%.@@%.......
..........................
..........................
........@@......@@........
##.....@@@@....@@@@.....##
##.....@@@@....@@@@.....##
##....%.@@%...%.@@%.....##
##......................##
..........................
....##.....####.....##....
....####...#..#...####....
....####...#..#...####....
